1111111111111
1C00000000001
1000000000001
1P00000000E01
1111111111111
