1111111111111
1P0000000001
1000111100001
1000111100001
1C00111100C01
1000111100001
1000111100001
1000000000E01
1111111111111
